7 7 1
@@@@@@@
@w....@
@..@..@
@.@@@.@
@..@..@
@....$@
@@@@@@@